11111111111111
10000000000001
10101010101001
10000000000001
10000000000001
10000000000001
10000000000001
10000000000001
10000101000001
10001000100001
11111111111111